#############################################
#   #         #             #     #         #
### # ####### # ####### ### ### # ### ##### #
#   # #     # #         #   #   #   #     # #
# # # # ### # # ######### # # ##### ##### # #
# # # # # #   #     #     # # #         #   #
# ### ### # ### ### # ##### # # ########### #
#     #     # #   # #       # #       #     #
########### # # ### ######### ######### # ###
#       #   #   #       #   # #   #   #   # #
### ### # ### ### ##### # ### # ### # # ### #
#S  #     # #       #   #   # #     # #     #
# # ### ### # ####### ########### ### #######
# #     #   #   #   #           # # #     # #
# ####### ### ### ### ########### # ### # # #
# #         #     #   #       #     # # # # #
# ########### ####### # ##### # ####### # ###
#       #     #       #     # #         #   #
### ### # ### # ####### ### # ########### ###
#   # # # # # #     #     # #     #     #   #
# ### # # # # ##### ##### # ##### # ### # ###
#     #   #   #     #   # #   #   # # # #   #
### ####### ##### ##### # ### # ### # ### ###
#   #     #     #       #   #     #   #     #
# ##### # ##### ### ### ##### ####### ### ###
# #   # #   #   #   # #  T  #     #     #   #
# # ### ### # ##### # ### ### ### # ####### #
#   #       #       # #   #   #   #       # #
### ####### # ##### ### # ### ##### ##### # #
#     #   # # #   #     # #     #       # # #
# ##### ### # # ##### ### ##### ##### ### ###
# #     #     #     #     #     #     #     #
# # ########### ########### ########### #####
# #   #       #     #       #         #   # #
### ### ##### ##### # ##### ########### # # #
#     #     #       #     #   #       #   # #
### ##### ### ####### ####### ### ### ### ###
#   #     #   #         #         #   #     #
#############################################
