##############################
#S  #         #             ##
### # ####### # ####### ### ##
# # # #     #         #   # ##
# # # ### ############### # ##
#   #   #   #     #     # # ##
# ##### ### # ### # ### # ####
# #   #     # # # # # # #   ##
# # # ### ### # # # # # # # ##
#   # # # #   # #   #   # # ##
##### # # # ### ##### ### # ##
#     #   # #       # #   # ##
# ######### ### ### # # ### ##
#         #   #   # # #   # ##
######### ### # ### # ##### ##
#       #     # #   #     # ##
# # ########### # ####### # ##
# #     #       #         # ##
# ##### # ################# ##
# #   #   #T          #   # ##
# # # ######### ### # # # # ##
#   #         # #   # # # # ##
############# # # ### # # # ##
#       #     # # #   # #   ##
# ##### # ####### # ### ######
# #   # # #     # # #       ##
# ### # # # ### # # ####### ##
#     #     #     #         ##
##############################
